WTTXT1TTTT
TXZXTXTXHT
TTTTTXT1H3
1XTXTXZXHT
FF1F1FF1FF
